#########
#***##*M#
#*#*****#
#*#######
#**#****#
##*#**###
#*******E
#########